1##########
####-----#
###-------
###------#
###----###
###----###
###E----##
####------
#####---##
##########
2##########
##########
###----###
###E---###
-------###
###---####
###-------
###--#####
###-######
##########
3##########
----######
##---#####
###---M###
###----###
####---###
####--####
------####
##########
##########
